%T T T T T T T T T T T T%
%          F            %
%          C            %
%                       %
%                       %
%                       %
%                       %
%          f            %
% R T R T R T R T R T R %