%T T T T T T T T T T T T%
%          F            %
%                       %
%                       %
%    C   C   C   C      %
%                       %
%          c            %
%      m       m        %
%          a            %
%          f            %
%T T T T T T T T T T T T%