%T T T T T T T T T T T T%
%          F            %
%       R    R          %
%          C            %
%     C         C       %
%          C            %
%     T         T       %
%          c            %
%     m          m      %
%          a            %
%       R    R          %
%          f            %
%T T T T T T T T T T T T%