%T T T T T T T T T T T T%
%          F            %
%       R    R          %
%          A            %
%     M         M       %
%          C            %
%     T         T       %
%          c            %
%     m         m       %
%          a            %
%       R    R          %
%          f            %
%T T T T T T T T T T T T%
