%T T T T T T T T T T T T%
%          F            %
%                       %
%          A            %
%                       %
%     C         C       %
%          M            %
%  R                 R  %
%                       %
%     T         T       %
%                       %
%     T         T       %
%  R                 R  %
%          m            %
%     c         c       %
%                       %
%          a            %
%                       %
%          f            %
%T T T T T T T T T T T T%
