%T T T T T T T T T T T T%
%          F            %
%          A            %
%                       %
%                       %
%                       %
%                       %
%          f            %
% R T R T R T R T R T R %