%T T T T T T T T T T T T%
%          F            %
%          M            %
%                       %
%                       %
%                       %
%          f            %
% R T R T R T R T R T R %