%T T T T%
%   F   %
%   A   %
%       %
%   f   %
%T T T T%
