%T T T T T T T T T T T T%
%          F            %
%                       %
%          A            %
%                       %
%     C         C       %
%                       %
%  R                 R  %
%                       %
%     T         T       %
%                       %
%     T         T       %
%  R                 R  %
%                       %
%     C         C       %
%                       %
%          A            %
%                       %
%          F            %
%T T T T T T T T T T T T%